##                ##########
## ##  ######              #
#     #######     ##########
# ## ########              #
     #################    B#
A###########################
